Name: TD-Map
Size: 11x19
xxxxxxxxxxxxxxxxxxxxx
x.....x...x...x...xxx
x.xxx.x.x.x.x.x.x.xxx
x...x.x.x.x.x.x.x.xxx
xxx.x.x.x.x.x.x.x.xxx
xxx.x.x.x.x.x.x.x.xxx
-.x.x.x.x.x.x.x.x.x.-
x.x.x.x.x.x.x.x.x.x.x
x.x.x.x.x.x.x.x.x.x.x
x.1.x.x.x.x.x.x.x.x.x
x...x...x...x...x...x
xxxxxxxxxxxxxxxxxxxxx